["xxxxxxxxxxxxxxxxxxxxxxxxxxxxxxxx      xxxxxxxxxxxx",
"x        x                 x                     x",
"x        x                 x                     x",
"x        x                 x                     x",
"x        x                              A        x",
"x                                                x",
"x                                                x",
"x     A                                          x",
"x                                                x",
"x           x              x                     x",
"x           x              x                     x",
"x           x              x                     x",
"xxxxx       xxxxxxxxx  xxxxxxxxxxxxxx       xxxxxx",
"                   xx                             ",
"                   xx                             ",
"                   xx                             ",
"                   xx                             ",
"x                  xx                            x",
"x                  x                             x",
"x                  x                             x",
"x    xxxxxxxxx     x                 xxxx        x",
"x                  x                 xxxx        x",
"x                                    xxxx        x",
"x                           xxxxxxxxxxxxx        x",
"x                           xxxxxxxxxxxxx        x",
"x                                                x",
"x                  x                             x",
"x                  x                             x",
"x                  x                             x",
"x                  x                             x",
"x                  x                             x",
"x                  x                A            x",
"x                  x                             x",
"x                  x                             x",
"xxxxxxxxxxxxxxxxxxxxxxxxxxxxxxxx      xxxxxxxxxxxx"]