xxxxxxxxxxxxxxxxxxxxxxxxxxxxxxxxxxxxxxxxxxxxxxxxxx
x        x                                       x
x        x                                       x
x        x                                       x
x        x                                       x
x                                                x
x                                                x
x                                                x
x                                                x
x           x                                    x
x           x                                    x
x           x                                    x
xxxxx       xxxxxxxx                             x
x                  x                             x
x                  x                             x
x                  x                             x
x                  x                             x
x                  x                             x
x                  x                             x
x                  x                             x
x    xxxxxxxxx     x                             x
x                  x                             x
x                                                x
x                                                x
x                                                x
x                                                x
x                  x                             x
x                  x                             x
x                  x                             x
x                  x                             x
x                  x                             x
x                  x                             x
x                  x                             x
x                  x                             x
xxxxxxxxxxxxxxxxxxxxxxxxxxxxxxxxxxxxxxxxxxxxxxxxxx